00000000000
00000000000
00001010000
01111111110
00000000000
00000000000
00000000000
00000000000
00000000000
00000000000
00000000000
00000000000
00000000000