05000000000
00000000000
05000000000
05000010000
05000121000
05001212100
05012141210
05001212100
05000121000
05000010000
05000000000
05000000000
05555555555