00000000000
22202220222
21202120212
22202220222
00000000000
00222022200
00232023200
00222022200
00000000000
22202220222
21202120212
22202220222
00000000000