00000000000
00000000000
04444444440
03333333330
02222222220
01111111110
02222222220
01111111110
00000000000
00000000000
00000000000
00000000000
00000000000