00000100000
00011422000
00114442200
01144444220
01144444220
01144444220
01010101010
00000100000
00000100000
00050500000
00055500000
00005000000
00000000000