00000000000
00000000000
01111111110
01000000010
01022222010
01020002010
01020502010
01020002010
01022222010
01000000010
01111111110
00000000000
00000000000