00020002000
00002020000
00002020000
00022222000
00022222000
00244244200
00244244200
02222222220
02222222220
02022222020
02020002020
02020002020
00002020000