55555555555
00005000520
05305000500
05005050500
05005050500
05005350500
05025052500
05005450500
05005050500
05005050500
05100050000
05000050000
05555555555