00000000000
30000000000
32000000000
32100000000
32130000000
32132000000
32132100000
32132130000
32132132000
32132132100
32132132130
44444444441
00000000000