11111111111
00000000000
11111111111
00000000000
55555555222
00000000000
11111111111
00000000000
22255555555
00000000000
11111111111
00000000000
55555555111