00010001000
00001010000
00001010000
00011111000
00011111000
00111111100
00111111100
01111111110
01111111110
01011111010
01010001010
01010001010
00001010000